000000000000000000000000000000000
010111111111110111111111011111110
010100000001010000000101000000010
010111011111010111111101110111110
010000010000010100000000010100010
010111110111010111111101011101110
010100000101010000000101000001000
010101110101110111111101011101010
010100010100000100000001010101010
011101110101110111011111010101010
000001010101010001000001010101010
011101010111011101111101110111110
010101000000000101000101000000010
010111011101111101110101011111010
010001010101000000010100010001010
011101010101011111010111010101010
000101010101000101000001010101000
011101010111011101111101011101110
010000010000010000000101000100010
011101110111110111111101110101110
010101000100000100000001010101010
010101111101110111010111010101010
000100000001000001010101000101000
011111011101111101010101111101110
010100010101000101010100000000010
010101110101110111011101011111010
010001000100010000010001010001010
011111110101110111011111011101110
010000000101000101000100000100010
010111011101111101011101110111010
010101010000000001000001010001010
011101011111111111111111011111010
000000000000000000000000000000000
