000000000000000000000000000000000
011101111111110111110111111111110
000100000100010101010000000001010
010111110101011101011111111101010
010000010101000001000000000101010
011101110101110111011111110111010
010101000101010100000000010000010
010111011111010111110111110111010
010000000000000000010100010001010
010111011111111111010101111111010
010101010000000001010100000001010
010101110111111101010111011111010
010100000000000101010001000100010
011101111111110101011101110101110
000001010000010101000101010101000
010111011101111101011101010101110
010100000100000001010001010000010
010111010111011101110111011111010
010001010001010100000001000101010
011101011101110101111101110101010
010001000100000101010100000101010
011101110111110111010111111101010
010100010001010000010000000001010
010111011101011111011111110111010
010100000101000001000000010100010
010111111101011111011111010111010
010000000000010001000001010000010
011101111111010101111111011101110
000100000101010100000001000101000
011101110101110111111101110101110
010001010100000101000000010100010
011111011101111101111111110111110
000000000000000000000000000000000
