000000000000000000000000000000000
010111011111111111011111011111110
010101000001000001010101010000010
010101110111011101010101110101110
010100010100000101000100000101000
010111011101111101110101111111110
010001000000010100010100000000010
011101111111010111010101111111010
000101000001010000010101000001010
010101110111011111110101110111010
010100010100010000000100010100000
011101110101111111110111010101110
010001000100000000010001010101010
011101110111111111011101110111010
000100010000000001000100000001010
010101010111111101010111111101010
010101010101000001010000000101010
010101010101011101011111110101010
010101010101010101010000010100010
010101111101010101011101010111010
010100000001010101010101010001010
010111111101010101010101010111010
010000000101010101010101010100010
011101110101010111010101110111010
010101000101010000010101000001010
010111011101010111010101011101010
010100010000010001010101010101010
010101110111011101110101110101110
010001000101000100000101000000010
011101011101110101111101011111010
010101010000010101000000010100010
010111110111111101111111110111110
000000000000000000000000000000000
