000000000000000000000000000000000
011101111101111111111111111111110
000101000001010000010000000000000
010101111111011111010111111101110
010101000000000001000100000101010
011101011101111111011111110111010
010001010001010000010000000000010
011101010111010111110111011101110
000101010100010100000101010101010
011101110101110101011101110111010
010000000100000101010100000100000
010111111101110111010101110101110
010101000001010001010001010001010
010101111111011101011111011111010
010001000000010001000000000000010
011101110111011101011111110111110
000100010101000101010001000100010
010101110101111101110101011101110
010100000100000000000101010001000
010101110111111111110111010111010
010101010000000001000100010100010
010101011111111101111111010101110
010101000000000101000001010100010
011101110111110101011101010111010
010001010001000100010100010001010
011101011101111111110111011101110
000101000100000000000001010100000
011101110101110111011101010111110
010000000101010100010101010000010
010111110111010111110101010111110
010001010000010100000101000100010
011111011111110111110111111101110
000000000000000000000000000000000
