000000000000000000000000000000000
011111110111011101111111011111010
000000010100010101010001010101010
011111010111110111011101010101110
010100010100000001000100010100000
010101110111011101110111110101110
010001000000010100010000000101010
011101110111110101010111010111010
010100010100000101010101010000010
010111010101110101011101111101110
000100010101000101000000000101000
011101110101011101011111011101110
010001000101010001010100010000010
011101111101011101110111110111010
010100000001000100000001000001010
010101110111110101111101011101010
010101010101010101000101010101010
010111011101010111010101110101010
010000000001000000010100000101010
010111111101111111011101110101010
010000010000000101010001010101010
011111110111111101011101010101010
000001000100000100000100010101010
010111011101011101110111010111010
010100010001010001010001010001010
011101010111110111011101010111010
010001010001000100010101010100010
010111011101011101110101011101110
010101000101010001000001000001000
010101011101010101111101011101110
010001010000010100000101010100010
011111011111111111110111110111110
000000000000000000000000000000000
