000000000000000000000000000000000
011101011111011101111111011101110
000101010101010101000101010101010
011101110101010101110101110111010
010001000101010100000100000000010
011101110101110101111101111111010
000100010100000101000000000001010
010111010111010101011111110111010
010001000001010101010000010100010
011101111111010111011101011101110
010000000000010000000101010001000
011111111101111111111101110111010
010000000101000100000000000100010
011101111101010111110111011101110
010001000001010000010101010001010
010111011101011111011101110111010
010100010101000001000000000100010
010101110111011101111101111101110
000101000000010101000001000100010
011101011111110111011101110111010
010101010000000001010100010001010
010101010111011111010111110101010
010001010101000000010000000101000
011101010101011111111111111101110
000101010101010000000000000000010
011101010101010101111101111101110
010001010101010101000101000101000
011111011101111101011101011101110
010000010000000001010001000100010
011101110111111101010111110111110
000100000100000101010000010000010
011111111101111111011111110111110
000000000000000000000000000000000
