000000000000000000000000000000000
011101111101111111111101111111110
000100010100000101000101000000010
010111110111110101011101011111010
010000000000010001010000010001010
010111110111011101010111110101110
010100010101000101010100000100010
010101010101110101010101110111110
010101010100010101010101010100000
010111011101110101010111010111010
010001000001010101010000010001010
010111011101010101011101110101010
010100010101000101000101000101010
010101110101011101011101110111110
010101000101010001010000010000010
011101110101011111010111110111010
010000010001000000010100010101000
011101110111011111010111010101110
000101000101010000010101010100010
010111011101110111110101010101110
010001010000010100000101000101010
011111010111110101110101111101010
010000010000000100010100000001010
011101110111111101110101111101010
000001010100000001010100000101000
011111010101111111010101111101110
010000000101010000000101000100010
010111110101011111011111011101010
010100010101000001010000000101010
011101011101111101111101110111010
010001000000000000000001010000010
011111111111111111111111011111110
000000000000000000000000000000000
