000000000000000000000000000000000
010111111111111111111111011111110
010000010000010000000000010100010
010111010111110111011111110111010
010101000100000101010000010001010
011101110111110101110111011101010
000000010100010100000101000001010
011111010111011101011101111111010
000101010001000001010000000000010
011101010101011111011101110111010
010000010101000001000101000101010
011111010101110111110101111101110
010001010100010100000101000000000
010101110111110101110101111111110
010100000100000101010101000000000
010111110101111101011101011111110
010001000100010101000000010000010
011101110111010101111111111111010
000100010001000100000000000000010
011101110101110111111101111111010
010001010100010001010001000001010
011101011111010111010111011101110
000101000000010100010100010100010
011101111111111101110111110111010
010000000000000001000000000001000
010111111111011101111111011101110
010100000001010100000000010100010
010111011101110101111111110111110
010001010100000101000000000000010
011101010101110111010111011101110
000101010001010000010101010101000
011111011111011111111101110111110
000000000000000000000000000000000
