000000000000000000000000000000000
010111011111111111111101111101110
010101000100010000000101000101010
011101110111011111110101110101010
000000010000000000010100010001010
011111011111111111110111011111010
000100000000000000000001000000010
011101111101111111011101110111010
010001010101000001010100010101010
011111010101011111010111110101110
000001010101010000010000000100000
011101010111011111011111110111110
010100010000000001000000010000010
010111110111011101111111010111110
010000000101010000000001010100010
010111111101011111111101011101010
010100010001000001000101000001010
010101110111110111011101011111110
010101000000010100000101010000000
010101111101111101110101011101110
010000010100000101010001000100010
010111010101110101011101110101110
010101000101010101000100010101000
011101110111010101011101110101110
010000010100010001010001000100010
011101110111011101011111110111110
000001000100000101000000000000010
011111011101110111011101111101110
010000000001010000010101010001000
011111111101011101110101010111010
010000000101000101000101010100010
011111110111110111110111011111110
000000000000000000000000000000000
