000000000000000000000000000000000
010111011111111111111101111111110
010101010100000000000001000100010
010101010111111111111111110101110
010101000100000000000000000100000
011101110111111101111111110111110
000000010000000101000000010001010
011111010111111101011111011101010
010000010100000001010001000101010
010111010111011101011101110101010
010101010001010101010101000100010
010101110111110101010101011101110
010100000100000101000100010001010
010101110101110101110111010111010
010101010001010001010001010100010
011101010111011101010111010111010
010001010100000101010100010101010
011111011101110101010111110101010
000000000001010101010100000001000
010111110111010101010111111101110
010100010101010100010000000101010
011101011101010111110101110101010
010001000001010000000101010101010
010111111101011111010111010101010
010100000101000001010100010100010
010111011101011101110111010111010
010000010001010100010001010001010
011111011101010111111101010111010
000001000101000000000001010100010
011101110101011111110111011101110
010100010101010000010100000000010
010111111101111111011111111111110
000000000000000000000000000000000
