00000000000000000
01011111011101110
01000101010101010
01111101110101010
00000000000101000
01011111011101110
01010001010000010
01111101010111010
01000001010101010
01011111011101110
00010000000000010
01110111111111010
01010100000101010
01010101011101010
01000101010000010
01111111011111110
00000000000000000
