00000000000000000
01110111111111110
00010001000000010
01011101011111110
01000100010000010
01110111011101010
01010001000101010
01011101111101110
01000000000001000
01011111111101010
01010000000101010
01010101111101010
01010101000001010
01010101011111010
01010101010000010
01111101111111110
00000000000000000
