00000000000000000
01110111011101110
00010101010101010
01010101110111010
01010000010000010
01110111011101110
01000101000001010
01011101111111010
01010000000000010
01110111110111110
00000100010100000
01111101010101110
01000101010100010
01010101110101110
01010100000101010
01110111111111010
00000000000000000
