00000000000000000
01011111111111110
01000101000000010
01110101011101110
00010001010101000
01011111010101010
01000000000101010
01111111111101110
01000000000000010
01111101111111010
01000101000100010
01011101110111010
01010000010001010
01010111110101110
01010100000100000
01011111111111110
00000000000000000
