00000000000000000
01111101011111110
00000101010000010
01011101110111010
01010001000101010
01110111011101110
01000000010000010
01011111110111010
01000101000101010
01011101011101010
01010000010001010
01011111111101010
01010000000101010
01010111110101010
01000100010001010
01111101111111010
00000000000000000
