00000000000000000
01110111111101110
00010100000101010
01110101110111010
01000001010000010
01111101011111010
00000101000001010
01110101011111010
01010101010000010
01010101011101110
01010101000100010
01010101110111010
01000101010001010
01110101010111010
01010100010100010
01011111110111110
00000000000000000
