00000000000000000
01111101111111110
00000101010000010
01111101011101110
01000001000100000
01110111110111110
00010000000100010
01010111110111010
01010100010100010
01110111010101110
01000001010101010
01011111010101010
01010000010001000
01110111011101110
00000101000100010
01111101111111110
00000000000000000
