00000000000000000
01111111110111110
00000000010100010
01111111011101010
01000001000001010
01011111111111010
01000000010000010
01011101110111110
01010100010100000
01110111010111010
01000001000001010
01111101111101110
00000100010100010
01111101010101110
01000001010001000
01111111011111110
00000000000000000
