00000000000000000
01110111111101110
00010100000101000
01011101011101110
01000001010000010
01111111011111110
01000000000000010
01110111111101110
01010100000101000
01011111110101010
00000000000101010
01111111111101110
01000000000100010
01011111110101110
01010000010001000
01111111011111110
00000000000000000
