00000000000000000
01111111110111110
00000000010001010
01111111011101010
01000001000101010
01110111011101010
01000101010000010
01011101010111110
00010000010100000
01110111110111110
01010100000100010
01010111010101010
01000001010101010
01011111011111010
01010000000000010
01111111111111110
00000000000000000
