000000000
011111110
000000010
011101110
010101000
010111010
010000010
011111110
000000000
