000000000
011101110
000101010
011101010
010001010
011101010
000100010
011111110
000000000
