000000000
010111110
010000010
010111110
010100010
010101010
010101010
011101110
000000000
