000000000
010111010
010101010
010101110
010100010
010111010
010001010
011111010
000000000
