000000000
010111010
010101010
011101110
000000010
011111010
010100010
010111110
000000000
