000000000
011111010
000001010
011101110
010100010
010111010
010001010
011101110
000000000
