000000000
011101110
000101010
010101010
010100010
010111110
010000010
011111110
000000000
