000000000
010111110
010100010
010111010
010001010
011101010
000101010
011111010
000000000
