000000000
010111010
010101010
011101010
000001010
011101010
010101010
010111110
000000000
