00000000000000000000000000000000000000000000000000000000000000000
01111101110111111111111111111101111111111111110101111111110111110
00000101010000000000000100000001010000000000010101000100010001010
01110111011101110111110111111111010111111111010101110101011111010
01000000000101010100010100000000010000000100010100010101000000010
01111111110111011101010111011111011111110111110111110101111111010
00010000010000000001010001000001000000010001000000000101000001010
01110111011111111101110111111101111111011101111101110101011111010
01000001000100000001000000000100010001000100000101010101010100010
01111101011101110111011101111111110101010101110111011101010101110
01000101010001010100010100000000000101010101000100000000010001000
01110101111101010111110111111111011111010101110101111111010111010
00010101000001010000000000000001010000010101010101000001010100010
01110101010111011111111111111101011111010101011101111101011101110
00000101010100000001000000000001000001010100000101000001010001010
01111101010101111101111111111101110111110111110101011101010111010
01000001010101000100000100000100010100000001010001010101010000010
01110111110101110101110111011111010101111101011111010111011111110
00010000000101010101010100010000010101000100000000010000000000000
01110111110101010101010101110111110101011111111111011101111111110
01010100010100010101010001010100000001000000000001000101000000010
01010111011101110101011111010111111101011111010111011101011111010
01000001000001000101000000000000000101010001010100010101010001010
01111101111111010101011101111111110101111101011101110101110111010
00010100000000010101010101000100010100000001010001000000000100010
01110111111101111101110111010101110111011111011101011101110101010
01000000000101000000000000010100000001010000000101010101010101010
01110111111101011111110111110111111101110111110101110111011111010
00010100000101000100010001010000010000000101000100000001000000010
01110101110101110101110111011111011111011101011101111101111101110
01010001010000010101000100000100000101010001010001000100010001010
01010111010111011101111101110101110101011101010111010101010111010
01000100010101000000000101010001010101000100010100010101010100000
01110111011101111111111101011101010101111101110101110101110111110
01010001000000000001000001000101010100000101000101000100000001010
01011101011101111101011111011111011101110101011101110101111101010
01000101010101000101010001000000000101010001010001010101000100010
01011101110101011101010111011101110101011101110111010111010111110
00010000010001010001010000010101000101000100000000010000010000010
01110111110111011101011111110101111101011101111111011111111101110
01000100000100000100000100000100000001010100010001010100000101000
01011101011101110111110111011101111111010111010111010101110101110
01010001010000010000010000010001000000010001010100010101010000010
01011111011111011111011101110111011111011101110111010101011111010
01010000000001010001000101010100010000000100000001010101000100010
01110111110111010111110101010101011101111101111111110101110111110
01000100010100010100000101000101010101000001000000000000010000000
01110111011101110101111101011101010101110101110111111111110111110
00010001000001000101000001010001010100010101000100000000000000010
01111101011111110111110111011101010111010111011101111111111111010
00000101000000000000010100000101010001010001010000010001000001010
01110101111111111111010101111101011101011101011111011101111101010
01010000000001000001010101000001010001000100000001000100000101010
01011111111101011111011101111101010111110101111111011101110101110
01000000000100010000000100000101010100010101000000000001010100010
01110111011111110111110111011101110111010101111111111111010101110
01010101000000000101000100010001000001000100000000000000010100000
01010101111101111101011101110111011101011101111101110111010111110
01010100000100010001010001000001010001010001010001010101010100010
01011101110111011101111101111101011101010111011111011101110101110
01000001000001000000000000000101000101010100000000000000000001010
01110111111101011111110111110101111101011101111101111111110111010
00010000010101010000010100010100000001000001000100000001010100010
01111111110101111111011111011111111111111111011111111111011101110
00000000000000000000000000000000000000000000000000000000000000000
